###################################
#       #       #     #       #   #
# ##### ##### # # ### # # # ### # #
#     #       # # #   # # # #   # #
# ### ########### # ### # ### ### #
# # #         #   #   # # #   #   #
# # ######### # ##### # # # ### ###
# #   #     #   #   # # # #   #   #
# # # # ##### ### # # ### # ##### #
# # # #     #   # #   #   # #     #
# ### ##### ##### ##### ### # #####
#   #     #       #     #   # #   #
### ### # ######### ### # ### # # #
# #   # #         #  a#     #   # #
# ### # ######### # ############# #
#     #   #     # # #     #     # #
# ####### # # # # # # ### # ### # #
#         # # # # # # # # # #b# # #
########### # ### ### # # # # # # #
#           #         #     #     #
###################################