#######################################################
#   #                   #a    #               #       #
# # # ########### ##### ### # # ############# ####### #
# # # #         #     #     # #     #       #     #   #
# ### ### # ### ##### ####### ##### # ##### ##### # # #
#   #   # #   #   # # #     #     # #     #     #   # #
### ### ##### ### # # # # ####### # # ### ########### #
#   # #   #   #     # # # #       # # # #           # #
# # # ### # ######### # # # ####### # # ########### # #
# #     # #   #       # #           #     #         # #
# ####### ### # ####### ################# # ######### #
#     #   #   # #   #   #   #           # #   #       #
# ### # ### # # ### # ### ### ##### ### # ### # #######
# #   # #   # #   #       #   #   #   # #   #   #     #
# # ### # ### ### ######### ### # ### # ##### ### ### #
# #   #   # # # #   #       #   #   # #     #   # #   #
# ### ##### # # ### # ####### ##### # ##### ### # ### #
#   #     # # #   # #     #   #   # # #   # #   #   # #
####### # # # # # # # ##### ##### # # # ### # ##### # #
#       #   #   # #   #     #     # #   #   #       # #
# ######### ##### ##### ##### # ### ##### ########### #
# # #           # #   #   #   #         # #         # #
# # # ########### # ##### # ########### # # ####### ###
# #       #   #   # #   # #   #     # # #         #   #
# ######### # # ### # # # ##### ### # # ####### ##### #
#   #   #   #   # #   # #       # # #   #   #   #   # #
# # # # # ####### # ### ######### # # ### # # ### # # #
# #   #   # #         #         # # #     # #   # #   #
# ######### # ########### ##### # # # ##### ##### #####
#   #       # # #     #   #   # # # # #   #   #   #   #
### # # ##### # # ### # ### ### # # ### # ### # ##### #
# # # #     #   # # #   #     # # # #   # #   #   #   #
# # ####### ### # # ##### ### # # # # ### # ##### # # #
# #   #   #     # #         # #   # #   # #     # # #b#
# ### # # # ##### ########### ### # ### # ##### # # ###
#     # # #   #   #         #     # #   #   #     #   #
# ##### # ##### # # ####### ### ### # ##### ######### #
# #     # #     # #       #   # # #   #   #   #     # #
# # # ### # ########### ##### # # ####### ### # ### # #
# # #   # #       #   # #     # #           #   #   # #
# ##### # ####### # # # # ##### ####### ### ##### ### #
#   #   #   #   #   #   #   # #       # # #     #   # #
### # ##### # # ########### # ####### # # ##### ### # #
# #   #   #   # #   #     # # #     #   #     #   # # #
# ##### ####### # # # ### # # # ### ##### ##### ### # #
#             #   #   # #   #   # # #   #   #   #   # #
# ########### ######### ##### ### # # # # # # ### ### #
#   #   #       #     #       #   #   #   #   #   #   #
### # # # ### ### # # # ####### # ############# ### # #
#     # # #   #   # # # #   #   #   #         # #   # #
# ####### # ### ### ### # # ##### # ### # ##### # #####
#   #   # #   #   #     # #       #   # # #   # # #   #
### # # # ####### ####### ########### ### # # # # # # #
#   # #   #       #     #   #       #   #   # # #   # #
# ### ##### ######### # # # # ### ##### ##### ### ### #
# # #     #     #   # #   # #   #     #       #   #   #
# # ##### ##### # # ####### ### ##### ####### ##### # #
#       #         #         #       #               # #
#######################################################